8
0 1 3 8 4 9 5 4
5 0 2 6 7 2 1 7
1 8 0 1 2 6 7 8
7 4 5 0 3 5 4 8
7 4 8 6 0 5 4 8
7 4 3 9 3 0 4 8
7 4 9 8 3 5 0 8
7 4 7 4 3 5 4 0