20
 0 12  1 12 10  5  6 11  7  3 19  2 18  8 17 12  5 11 12 16 
18  0  5  5 12  6  5 14  4 19  7 16  2  5 17 18  2  4 17 10 
13 13  0 10 19 18  7  9  5  1  7 10 18 15  2 10 15  7  8  6 
12 10  5  0  7 14 18 16  9 14  1  4 13  7 18 15  8  8  1 15 
 6 11 12 16  0  3 14 18 19  1 10  2 18 18 13 14  3  7 17 16 
 1  6  1 11  4  0  1 14 16 19  2 13 15  8  7 14 13 14  2 12 
10 18  5 16 17  2  0 17  4  7  6 12 10 17  3  5  1  2  8 17 
 8 10  2 19  5  6 12  0  8 11 11 12 16 15 11  7  1 15 18 16 
13  3  1  3  7 15 18 14  0 18  1  1 14  2 17  6 11  7  3  6 
14 19  2 14  4 11 13 11 11  0 16  3 10  3 18  1  4  3 10  8 
 7  3 19  7  6 15  6 12 13  3  0  9  1 18 13 10 14 16 11  1 
14 18  8  7  1 19 13 15  4  6 18  0  8  2 14 10 10 13  3 15 
12 12 19 15  9  1 17  1 15  7 17  3  0 17  7 11 18 10  2 19 
 1  4  1 19 11 15  9 10  9  7 10 14  1  0  4 16  1 16  2  2 
18 12 16 15 16  9 17 15 13  5  5  3  7  9  0  5 12 18  8  4 
 1  6  1  9  8  3  7  1 13 19  8 13  3 19 14  0 16  1 10  3 
 1  7 17 10  2 12 18  7  4 10  7 14 18  2  6 17  0  3 11  4 
 1  4  7  6 12  3 19  6  1 14  9  8  7 13  4 16 12  0 10  4 
 3  4  6 14 16 14 11 12  1  6  6 18  7 16  2  5  7 16  0  1 
15 16  1  4 11  3  1  5  5 19 15  2  4  7  1 19  8 19 18  0 
